#################
#...............#
#...............#
#....######.....#
#....#....#.....#
#.........#.....#
#...............#
#...............#
#################